UUUUUUUUUUUUUUUUUUUUUUUUUUUUUUUUUUUUUUUUUUUUUUUUUUUUUUUUUUUUUUUUUUUUUUUUUUUUUUUUUUUUUUUUUUUUUUUUUUUUUUUUUUUUUUUUUUUUUUUUUUUU
UUUUUUUUUUUUUUUUUUUUUUUUUUUUUUUUUUUUUUUUUUUUUUUUUUUUUUUUUUUUUUUUUUUUUUUUUUUUUUUUUUUUUUUUUUUUUUUUUUUUUUUUUUUUUUUUUUUUUUUUUUUU
UUUUUUUUUUUUUUUUUUUUUUUUUUUUUUUUUUUUUUUUUUUUUUUUUUUUUUUUUUUUUUUUUUUUUUUUUUUUUUUUUUUUUUUUUUUUUUUUUUUUUUUUUUUUUUUUUUUUUUUUUUUU
UUUUUUUUUUUUUUUUUUUUUUUUUUUUUUUUUUUUUUUUUUUUUUUUUUUUUUUUUUUUUUUUUUUUUUUUUUUUUUUUUUUUUUUUUUUUUUUUUUUUUUUUUUUUUUUUUUUUUUUUUUUU
UUUUUUUUUUUUUUUUUUUUUUUUUUUUUUUUUUUUUUUUUUUUUUUUUUCCCCCUUUUUUUUUUUUUUUUUUUUUUUUUUUUUUUUUUUUUUUUUUUUUUUUUUUCCUUUUUUUUUUUUUUUU
UUUUUUUUUCCCCCCCCCCCCUUUUUUUUUUUUUUUUUUUUUUUUUUCCCCCCCCCCCUUUUUUUUUUUUUUUUUUUUCCCCCCCCCCUUUUUUUUUUUUUUUUUCCCCUUUUUUUUUUUUUUU
UUUUUUUCCCCCCCCCCCCCCCCUUUUUUUUUUUUUUUUUUUUUUUCCCCCCCCCCCCCUUUUUUUUUUUUUUUUUCCCCCCCCCCCCCUUUUUUUUUUUUUUCCCCCUUUCCCCCUUUUUUUU
UUUUUUUUCCCCCCCCCCCCCUUUUUUUUUUUUUUUUUUUUUUUUUUUUUUUUUUUUUUUUUUUUUUUUUUUUUCCCCCCCCCCCCCCUUUUUUUUUUUUUUUUUUUUCCCCCCCCCCCUUUUU
UUUQEUUUUUUUUUQEUUUUUQEUUUUUUUUUQEUUUUUQEUUUUUUUUUQEUUUUUQEUUUUUUUUUQEUUUUUQEUUUUUUUUUQEUUUUUQEUUUUUUUUUQEUUUUUQEUUUUUUUUUQE
EUQWWEUUUUUUUQWWEQEUQWWEUUUUUUUQWWEQEUQWWEUUUUUUUQWWEQEUQWWEUUUUUUUQWWEQEUQWWEUUUUUUUQWWEQEUQWWEUUUUUUUQWWEQEUQWWEUUUUUUUQWW
WWWWWWEUUUQEQWWWWWWWWWWWEUUUQEQWWWWWWWWWWWEUUUQEQWWWWWWWWWWWEUUUQEQWWWWWWWWWWWEUUUQEQWWWWWWWWWWWEUUUQEQWWWWWWWWWWWEUUUQEQWWW
WWWWWWWEUQWWWWWWWWWWWWWWWEUQWWWWWWWWWWWWWWWEUQWWWWWWWWWWWWWWWEUQWWWWWWWWWWWWWWWEUQWWWWWWWWWWWWWWWEUQWWWWWWWWWWWWWWWEUQWWWWWW
WWWWWWWWWWWWWWWWWWWWWWWWWWWWWWGGGGGGGGGWWWWWWWWWWWWWWWWWWWWWWWWWWWWWWWWWWWWWWWWWWWWWWWWWWWWWWWWWWWWWWWWWWWWWWWWWWWWWWWWWWWWW
WWWWWWASDWWGGGSDWWWWWWWWASDWGGFFFFFFFFFWWWASDWWWWASDWWWWWWWWASDWWWWASDWWWWWWWWASDWWWWASDWWWWWWWWASDWWWWASDWWWWWWWWASDWWWWASD
WASDWASSSDWFGFSSDWWASDWGSSSDFFBBBBBBBBBDWASSSDWWASSSDWWASDWASSSDWWASSSDWWASDWASSSDWWASSSDWWASDWASSSDWWASSSDWWASDWASSSDWWASSS
ASSSSSSSGSSSFSSSSDASSSSFSSSPBBBBBBBBBBBSSSSPSSSSSSSSSDASSSSSSSSSSSSSSSSDASSSPSSSSSSSSSSSSDASSSSSSSSSSSSSSSSDASSSSSSSSSPSGGGG
SSSSSSSSFSSSSPSSSSSSSSSSSSSLBBBBBBBBBBBSSSSLSSSSGGGGPSSSSSSSSSSSSSSSSSSSSSSSLSSSSSSSSSSSSSSSSSSSSSSSSSSSSSSSSSSSSSSGGGGGGGGG
GGGGGGSSSSSSSLSSSSSSSSSSSGGGGBBBBBBBBBBSSSSLSSGGGGGGGGSSSSSSSSSSSSSSSSGGGGGGGGGGGGGGGGGGGGGGGGGGGGGGSSSSSPSSSSSSGGGGGGGGGGGG
GGFFGGGGGGGGGGGGGGGGGGGGGGGGGGGGGGGGGGGGGGGGGGGGGGGGGGGGGGGGGGGGGGGGGGGGGGGGGGGGGGGGGGGGGGGGGGGGGGGGGGGGGGGGGGGGGGGGGGGGGGGG
FFBBFGGGGGGGGGGGGGGGGGGGGGGGGGGGGGGGGGGGGGGGGGGGGGGGGGGGGGGGGGGGGGGGGGGGGGGGGGGGGGGGGGGGGGGGGGGGGGGGGGGGGGGGGGGGGGGGGGGGGGGG
BBBBBFFFFFFFFFFFFFFFFFFFFFFFFFFFFFFFFFFFFFFFFFFFFFFFFFFFFFFFFFFFFFFFFFFFFFFFFFFFFFFFFFFFFFFFFFFFFFFFFFFFFFFFFFFFFFFFFFFFFFFF
BBBBBBBBBBBBBBBBBBBBBBBBBBBBBBBBBBBBBBBBBBBBBBBBBBBBBBBBBBBBBBBBBBBBBBBBBBBBBBBBBBBBBBBBBBBBBBBBBBBBBBBBBBBBBBBBBBBBBBBBBBBB
BBBBBBBBBBBBBBBBBBBBBBBBBBBBBBBBBBBBBBBBBBBBBBBBBBBBBBBBBBBBBBBBBBBBBBBBBBBBBBBBBBBBBBBBBBBBBBBBBBBBBBBBBBBBBBBBBBBBBBBBBBBB
BBBBBBBBBBBBBBBBBBBBBBBBBBBBBBBBBBBBBBBBBBBBBBBBBBBBBBBBBBBBBBBBBBBBBBBBBBBBBBBBBBBBBBBBBBBBBBBBBBBBBBBBBBBBBBBBBBBBBBBBBBBB
BBBBBBBBBBBBBBBBBBBBBBBBBBBBBBBBBBBBBBBBBBBBBBBBBBBBBBBBBBBBBBBBBBBBBBBBBBBBBBBBBBBBBBBBBBBBBBBBBBBBBBBBBBBBBBBBBBBBBBBBBBBB
BBBBBBBBBBBBBBBBBBBBBBBBBBBBBBBBBBBBBBBBBBBBBBBBBBBBBBBBBBBBBBBBBBBBBBBBBBBBBBBBBBBBBBBBBBBBBBBBBBBBBBBBBBBBBBBBBBBBBBBBBBBB
BBBBBBBBBBBBBBBBBBBBBBBBBBBBBBBBBBBBBBBBBBBBBBBBBBBBBBBBBBBBBBBBBBBBBBBBBBBBBBBBBBBBBBBBBBBBBBBBBBBBBBBBBBBBBBBBBBBBBBBBBBBB
BBBBBBBBBBBBBBBBBBBBBBBBBBBBBBBBBBBBBBBBBBBBBBBBBBBBBBBBBBBBBBBBBBBBBBBBBBBBBBBBBBBBBBBBBBBBBBBBBBBBBBBBBBBBBBBBBBBBBBBBBBBB